########################################
########################################
########################################
#########################.......########
########################.........#######
#######################...........######
########################.........#######
#########################.......########
##########################.....#########
##########################.....#########
##########################.....#########
##########################.....#########
##########################.....#########
##########################.....#########
##########################.....#########
##########################.....#########
##########################.....#########
#......................................#
#......................................#
#......................................#
#......................................#
#......................................#
#......................................#
#......................................#
#......................................#
#......................................#
#......................................#
#..................#####################
#......................................#
#......................................#
#..................###############.....#
#..................#.............#.....#
#..................#.............#.....#
####################.............#.....#
#..................#.......#.....#.....#
#..................#.......#.....#.....#
#....#########.....#.......#.....#.....#
#....#.............#.......#.....#.....#
#....#.....................#...........#
#@...#.....................#...........#
########################################